##################################
#                                #
#                                #
#                 ######         #
#                 #    #         #
####   ############    #         #
#                      ## ###### #
#                                #
##################################